XXXXX
X w X
X  fX
X g X
XXXXX
