XXXXX
X w X
X  fX
X   X
XXXXX
